1111111111
1000000001
1000000001
1000000001
1000000001
1000000001
1000000001
1000000001
1000000001
1000100001
1000100001
1000100001
1000100001
1000100001
1111111111