1111111111
1000002001
1000000001
1001111111
1000000001
1110001111
1000001031
1001111001
1000001001
1000101001
1000101001
1000101001
1000101001
1000100001
1111111111